5 5
1 1
5 4
1 1 5 1 1
3 X 1 1 1
X 1 1 1 4
1 1 1 1 1
1 1 1 1 1